1111111111
100C000011
1P11111111
1E11111111
1C110X0011
1111111111